1111111111111
1E010C00000C1
100F01101C001
1C00000C100P1
1111111111111
