11111111111111
1C0000100000E1
100F0010C00001
100001F1000001
10000000000001
10C001F100C001
100000100F0001
1P000C10C000C1
11111111111111
