11111111111111111111111111111111111
100000C00000000C00010C00000000000C1
1P0000000000000000000000000C0000001
1000C000000C000000010F0000000000E01
11111111111111111111111111111111111
