111111111
1P000E11
10C1111
100011
111111111
