11111111
10000001
1E000E01
10001111
11111111
