1111111
10E0001
10C00P1
1000T01
1111111
